R    800    800

S    ../cub3D/assets/sprites/fiddle.xpm

NO    ../cub3D/assets/sprites/eagle.xpm
SO    ../cub3D/assets/sprites/bluestone.xpm
WE    ../cub3D/assets/sprites/wood.xpm
EA    ../cub3D/assets/sprites/redbrick.xpm

F    103, 166, 19
C    64, 198, 255

111111111111111111
100000002000000001
100000000000000001
100000000000000001
100000000000000001
100000000000000001
10000000N000000001
100000000000000001
100000000000000001
100000000000000001
100000000000000001
100000002000000001
111111100011111111
      11111
