R 1920 1080
NO assets/texture.xmp
SO assets/texture.xmp
WE assets/texture.xmp
EA assets/texture.xmp
S assets/texture.xmp
F 200  , 200 ,  25
C 221,50,0

1111111111
1000000001
10E0000001
1000011001
1000001001
1111111111