R 1920 1080
NO assets/textureno.xmp
SO assets/textureso.xmp
WE assets/texturewe.xmp
EA assets/textureea.xmp
S assets/textures.xmp
F 255, 200, 25
C 221 ,50,2

11111111111111111
10000000010000111
10000100011110011
10000010S10000111
11111111111111111
