R 800 800
NO assets/sprites/mossy.xpm
SO assets/sprites/colorstone.xpm
WE assets/sprites/greystone.xpm
EA assets/sprites/redbrick.xpm
S assets/sprites/barrel.xpm
F 255, 200, 25
C 221 ,50,2

111111111111111
100000010000001
100000010000001
100100011000101
100100W00001111
100000000001111
111111111111111
