R 1920 1080
NO assets/textureno.xmp
SO assets/textureso.xmp
WE assets/texturewe.xmp
EA assets/textureea.xmp
S  eeeeee
F 255, 200, 25
C 221 ,50,2

1111111111
1000000001
10E0000001
1000011001
1000001001
1111111111