R     800 999

S    ../cub3D/assets/sprites/zombiehand.xpm
SO    ../cub3D/assets/sprites/mur-brique.xpm
WE    ../cub3D/assets/sprites/acacia.xpm
EA    ../cub3D/assets/sprites/deepslatediamond.xpm
NO    ../cub3D/assets/sprites/deepslate.xpm

F    155,118,83
C    135,206,235

11111111111
10000000001
10000S00001
10000000001
10020000001
10000000001
10020000021
10000001111
10000000001
11111111111
