R 1920 1080
NO assets/texture.xmp
SO assets/texture.xmp
WE assets/texture.xmp
EA assets/texture.xmp
S assets/texture.xmp
F 255, 200, 25
C 221 ,50,2

11111111111111111
10020000010000111
10000100011110011
10000010S10000111
11111111111111111
