R 800	800
NO assets/sprites/mossy.xpm
SO assets/sprites/purplestone.xpm
WE assets/sprites/wood.xpm
EA assets/sprites/redbrick.xpm
S assets/sprites/barrel.xpm
F 94, 157, 52
C 30 ,	50, 254

111111111111111
100000000000001
100001000000011     11111
100011100000011     10001
100001000000001     11111
100202000000001
100N00000000001
100000000000001
100000000000001
111111000001111
      11111
