R 800 800
NO assets/sprites/mossy.xpm
SO assets/sprites/bluestone.xpm
WE assets/sprites/wood.xpm
EA assets/sprites/redbrick.xpm
S assets/sprites/barrel.xpm
F 65, 43, 40
C 5 ,8, 200

       1

111111111111111
100000000000001
100000000000011
100000000000011
100000000000001
100020000020001
100000N00000001
100020000000001
100000000000001
100000000000001
100000000000001
100000000000001
100000000000001
100000000000001
100000000000001
100000000000001
100000000000001
100000000000001
100000000000001
100000000000001
100000000000001
100000000000001
100000000000001
100000000000001
100000000000001
100000000000001
100000000000001
100000000000001
100000000000001
100000000000001
100000000000001
100000000000001
100000000000001
100000000000001
100000000000001
100000000000001
100000000000001
100000000000001
100000000000001
100000000000001
100000000000001
100000000000001
100000000000001
100000000000001
100000000000001
100000000000001
100000000000001
100000000000001
100000000000001
100000000000001
100000000000001
100000000000001
100000000000001
100000000000001
100000000000001
100000000000001
100000000000001
100000000000001
100000000000001
100000000000001
100000000000001
100000000000001
100000000000001
100000000000001
100000000000001
111111111111111
