R     800 800

S    ../cub3D/assets/sprites/cara.xpm
SO    ../cub3D/assets/sprites/bluestone.xpm
WE    ../cub3D/assets/sprites/wood.xpm
EA    ../cub3D/assets/sprites/redbrick.xpm
NO    ../cub3D/assets/sprites/eagle.xpm

F    103,50 , 19
C    6, 8, 2

1111111111111111111
1000000020000000001
1200000000000000001
1000000000000110001
100020000N000011111
1000000000000000001
1000000100000020001
1000001010000000001
1000000100000000001
1000000100000000001
1000000100000000001
1000000100000000001
1000000100000000001
1000000100000000001
1000000100000000001
1000000100000000001
1000000100000000001
1000000002000000001
1111111111111111111
